abelo        : пчела
abismo       : пропасть, пучина
abnegacio    : самоотверженность
aboli        : отменять, уничтожать
abolicii     : отменять, уничтожать
abomeno      : отвращение
aboni        : выписывать, подписываться
abrupta      : внезапный, резкий
absoluta     : абслютный, безусловный
absorbi      : поглощать (силы, внимание)
abstini      : воздерживаться
abstrakta    : абстрактный, отвлеченный
absurda      : абсурдный, нелепый
abunda       : обильный, богатый
acida        : кислый, унылый
acxeti       : купить
adekvata     : адекватный, соответствующий
adepto       : последователь, сторонник
adiaux       : прощай(те)
adjektivo    : имя прилагательное
administri   : руководить, управлять
admiri       : восхищаться, любоваться
admoni       : увещевать, делать замечание
adoleska     : юный
adolta       : взрослый
adopti       : усыновить, одобрять
adreso       : адрес
adverbo      : наречие
aero         : воздух
aeroplano    : самолет
afabla       : вежливый, любезный
afekcio      : волнение, аффект
afekti       : манерничать, рисоваться
afero        : дело, занятие, вещь
afikso       : аффикс
afisxo       : афиша, объявление, плакат
aflikti      : огорчать, терзать
aforismo     : афоризм
agendo       : записная книжка
agento       : агент
agi          : действовать, пступать
agiti        : агитировать, возбуждать
agnoski      : признать
agordo       : настроение, настройка
agrabla      : приятный
agrara       : аграрный
agresi       : совершать агрессию
agrikulturo  : сельское хозяйство
agxo         : возраст
ajlo         : чеснок
ajn          : бы ни
akademio     : академия
akceli       : ускорять, усиливать
akcento      : ударение, усиление
akcepti      : принимать
akcesora     : дополнительный, второстепенный
akcidento    : несчастный случай, авария
akiri        : приобретать, добывать
akompani     : провожать, акомпанировать
akordo       : согласие, сгласссованность, аккорд
akra         : острый, резкий
akrostilo    : акростих
akso         : вал, ось
aktiva       : активный, энергичный
akto         : акт, документ
aktoro       : актёр
aktuala      : актуальный
akumuli      : накапливать, собирать
akurata      : аккуратный, пунктуальный
akustiko     : акустика
akusxi       : рожать
akuzi        : обвинять
akvarelo     : акварель
akvo         : вода
al           : к (предлог)
alarmo       : тревога, сигнал тревоги
alauxdo      : жаворонок
aleo         : аллея
alergio      : аллергия
alfabeto     : алфавит
alia         : другой, иной
alianco      : альянс
aliel        : иначе
alies        : принадлежащий другому
alineo       : абзац
aliteracio   : аллитерация
aliu         : другой человек
alkoholo     : алкоголь, спирт
almanako     : альманах
almenaux     : по крайней мере, хотя бы
almozo       : милостыня, подачка
alojo        : сплав
alta         : высокий, возвышенный
alterni      : чередоваться
aludi        : намекать
alumeto      : спичка
amara        : горький
amaso        : масса, толпа
amatoro      : любитель
ambaux       : оба
ambigua      : двусмысленный, неопределённый
ambulanco    : полевой госпиталь
ami          : любить
amiko        : друг
amnestio     : амнистия
amoro        : любовная связь
amplekso     : объём, размах
amuzi        : развлекать, веселить
anakronismo  : анахронизм
analfabeto   : неграмотный
analizi      : анализировать
analogio     : аналогия
ananaso      : ананас
anaso        : утка
anekdoto     : анекдот
angoro       : тревога, беспокойство
angulo       : угол
angxelo      : ангел
anheli       : задыхаться, пыхтеть
animalo      : животное
animo        : душа
ankaux       : и, тоже, также
ankoraux     : ещё
anomalio     : аномалия
anonci       : извещать, объявлять
anonima      : анонимный, безымянный
ansero       : гусь
anstataux    : вместо, взамен
antaux       : перед (о времени или пространстве)
anteno       : антенна
anticipi     : делать заранее, предвосхищать
antikva      : старинный, античный
antipatio    : неприязнь, антипатия
antitezo     : противопоставление
antologio    : антология
aparato      : прибор, аппарат
aparta       : особенный, отдельный
apartamento  : квартира
aparteni     : принадлежать
apelacii     : апеллировать, обращаться
apeli        : апеллировать, обращаться
apenaux      : едва, еле, почти
aperi        : возникать, появляться
aperta       : открытый
apetito      : аппетит
aplaudi      : аплодировать, одобрять
apliki       : пользоваться, применять
aplombo      : самоуверенность
apogi        : поддерживать, подпирать
apopleksio   : инсульт
aprilo       : апрель
apriora      : априорный
apro         : дикий кабан
aprobi       : принимать, соглашаться
apud         : возле, около
araneo       : паук
arangxi      : привести в порядок; устроить
arbitra      : произвольный
arbo         : дерево
arbusto      : куст
arcxo        : смычок
arda         : горячий, раскаленный; пылкий, страстный
areno        : арена
aresti       : арестовать
argumento    : довод, аргумент
argxento     : серебро
ario         : ария
aristokrato  : аристократ
arkitekto    : архитектор
arkivo       : архив
arko         : арка, дуга
armeo        : армия
armi         : вооружать
aroganta     : наглый
arogi        : присваивать
aromo        : аромат
arterio      : артерия, магистраль
artifiko     : ловкость; ухищрение
artiko       : сустав
artikolo     : статья, артикль
arto         : искусство
ascendi      : восходить, подниматься
aserti       : уверять, утверждать
asfalto      : асфальт
asigni       : ассигновать
asimili      : уподоблять; усваивать
asisti       : помогать, ассистировать
asocio       : общество, ассоциация
asonanso     : созвучие
aspekti      : выглядеть, иметь вид
aspiranturo  : аспирантура
aspiri       : желать, стремиться; претендовать
astronomio   : астрономия
ataki        : атаковать, нападать
atenci       : посягать, покушаться
atendi       : ждать
atenta       : внимательный
atesti       : свидетельствовать
atingi       : достигать, добираться
atlaso       : атлас
atmosfero    : атмосфера
atomo        : атом
atribui      : приписывать, присуждать, присваивать
aux          : или, либо
auxdaca      : решительный; смелый
auxdi        : слышать
auxguro      : предзнаменование; предсказание
auxgusto     : август
auxroro      : утренняя заря
auxskulti    : слушать
auxtenta     : подлинный
auxtentika   : подлинный
auxto        : автомобиль
auxtobiografio : автобиография
auxtobuso    : автобус
auxtografo   : автограф
auxtomato    : автомат
auxtomobilo  : автомобиль
auxtonoma    : автономный
auxtoritato  : авторитет
auxtoritatoj : власти
auxtoro      : автор
auxtuno      : осень
avantagxo    : преимущество
avara        : скупой
aventuro     : авантюра; приключение
avenuo       : проспект
averagxo     : средняя величина
averti       : предупреждать
aviado       : авиация
avida        : алчный, жадный
avizo        : извещение, уведомление
avo          : дед, дедушка
azeno        : осёл
azilo        : приют, убежище
babili       : непринужденно беседовать
bagatelo     : мелочь, пустяк
bakhxanalio  : вакханалия
baki         : печь
balado       : баллада
balai        : мести, подметать
balanci      : колебаться, раскачивать
balbuti      : лепетать, запинаться
baldaux      : вскоре, скоро
balkono      : балкон
balo         : бал
balono       : баллон; шар
balzamo      : бальзам
banala       : банальный
bandito      : бандит
bando        : банда, шайка; клика
bani         : купать
bankedo      : банкет
banko        : банк
bankroti     : обанкротиться
barakti      : барахтаться; метаться; трепетать
barbaro      : варвар
barbo        : борода
bardo        : бард
bareliefo    : барельеф
barelo       : бочка
barko        : барка, баркас
baro         : преграда, препятствие
baseno       : бассейн
basko        : пола
bastiono     : оплот, бастион
bastono      : палка, трость
batali       : бороться, драться
bati         : бить, ударять
bauxmi       : встать на дыбы
bazo         : база, основа, фундамент
beata        : безмятежный, блаженный
bebo         : младенец, малютка
bedauxri     : жалеть, огорчаться
bela         : красивый, прекрасный
beletro      : художественная литература
bendo        : лента
benko        : скамейка
beno         : благословение; счастье
benzino      : бензин
bero         : ягода
besto        : животное
betono       : бетон
betulo       : берёза
bezoni       : нуждаться
biblio       : библия
biblioteko   : библиотека
biciklo      : велосипед
bieno        : имение, поместье
biero        : пиво
bilanco      : баланс
bildo        : картина
bileto       : билет
biografio    : биография
birdo        : птица
blanka       : белый
blasfemi     : сквернословить
bleki        : мычать, кричать
blinda       : незрячий, слепой
blonda       : белокурый
blovi        : дуть
blua         : голубой, синий
boato        : лодка
boji         : лаять
boli         : кипеть
bombasta     : высокопарный
bombo        : бомба
bombono      : конфета
bona         : хороший, доброкачественный
bordero      : бордюр
bordo        : берег
bori         : бурить, сверлить
botelo       : бутыль
boto         : сапог
bovo         : бык
brako        : рука (выше кисти)
brancxo      : ветвь, ветка; отрасль
brava        : отличный; смелый
bravuro      : бравурность
brecxo       : брешь; прорезь; ущерб
bremso       : тормоз
breto        : полка
breviero     : краткий молитвенник
brido        : узда
brigado      : бригада
briko        : кирпич; брусок
brili        : блестеть, сиять
bronzo       : бронза
broso        : щётка
brosxuro     : брошюра
brovo        : бровь
brui         : шуметь
bruli        : гореть; пылать
bruna        : карий, коричневый
bruska       : грубый, резкий
brusto       : грудь
bruto        : скот
bubo         : мальчишка, сорванец
bufedo       : буфет
bukedo       : букет
bulko        : булка
bulo         : ком, комок
bulteno      : бюллетень
bulvardo     : бульвар
bunta        : пёстрый, цветной
burdo        : шмель
burgxo       : буржуа, мещанин
burokrato    : бюрократ
buso         : автобус
caro         : царь
cedi         : уступать, смириться,
celebri      : сдаться
celo         : цель, пункт назначения
cemento      : цемент
cent         : сто
centimetro   : сантиметр
centralo     : станция
centro       : центр
cenzuri      : цензуровать
cepo         : лук
certa        : достоверный, определенный
cervo        : олень
cetera       : другой
cezaro       : цезарь, император
cifero       : цифра
cigaredo     : сигарета
ciklo        : цикл
cimbalo      : цимбалы
cimo         : клоп
cindro       : пепел, зола
cinika       : циничный
cirklo       : круг, окружность
cirko        : цирк
cirkonstanco : обстоятельство
cirkuli      : циркулировать
citi         : цитировать, упоминать
citrolo      : арбуз
citrono      : лимон
civila       : гражданский, штатский
civilizo     : цивилизация
civitano     : гражданин
cxagreni     : огорчать
cxambro      : комната
cxampiono    : чемпион
cxapelo      : шляпа; знак ^ в эсперанто
cxapitro     : глава
cxar         : так как, потому что
cxarlatano   : шарлатан
cxarma       : милый, очаровательный
cxaro        : повозка, колесница
cxasi        : охотиться, преследовать
cxe          : у, при
cxefa        : главный; решающий
cxelo        : клетка, ячейка; тюремная камера
cxemizo      : рубашка, сорочка
cxeno        : цепь, цепочка
cxerko       : гроб
cxerpi       : черпать, извлекать
cxesi        : прекращаться, останавливаться
cxevalo      : конь, лошадь
cxi          : (частица, обозначающая близость)
cxia         : любой, всякий
cxial        : с любой целью
cxiam        : всегда, всё время
cxicxerono   : гид, экскурсовод
cxie         : везде
cxiel        : по-всякому
cxielo       : небо
cxien        : во все стороны
cxies        : общий, всех
cxifi        : мять
cxifono      : тряпка, лоскут
cxio         : всё
cxiom        : всё, целиком
cxirkaux     : вокруг; около, приблизительно
cxirpi       : стрекотать, чирикать
cxiu         : каждый, всякий
cxokolado    : шоколад
cxu          : ли; разве
da           : обозначает меру, качество
damagxi      : повреждать, портить
damni        : проклинать
danci        : танцевать
dangxero     : опасность
danki        : благодарить
dato         : дата, число
dauxri       : длиться, продолжаться
de           : от
decembro     : декабрь
deci         : надлежать, подобать
decidi       : решать, принимать решение
dedicxi      : посвящать
defendi      : защищать
defetismo    : пораженчество
deficito     : недостаток, дефицит
defii        : вызывать, бросать вызов
definitiva   : окончательный
degeli       : оттаивать, таять
dejxori      : дежурить; служить, занимать должность
dek          : десять
deklami      : декламировать
deklaracio   : декларация
deklari      : декларировать; объявлять
deklivo      : откос, склон
dekoracio    : декорация, украшение, оформление; награждение
dekoro       : декорация, украшение, оформление; награждение
dekreto      : декрет
dekstra      : правый
delegacio    : делегация
delegi       : делегировать
delikata     : деликатный; изящный; легкий
delikto      : проступок
demandi      : спрашивать
demokratio   : демократия
demokrato    : демократ
demono       : демон, дьявол
demonstracio : демонстрация
demonstri    : демонстрировать
denova       : повторный
densa        : плотный, частый, густой
dento        : зуб
dependi      : зависеть
deprimi      : приводить в уныние
deputi       : избирать депутатом
derivi       : образовывать, производить
desaponti    : разочаровывать
descendi     : спускаться
desegni      : рисовать; чертить
despero      : отчаяние
destini      : предназначать
detalo       : подробность
detekti      : обнаруживать
detektivo    : сыщик, детектив
determini    : определять, устанавливать
detrui       : истреблять; разрушать
deveni       : происходить, возникать
devi         : быть обязанным
devizo       : девиз
dezerto      : пустыня
deziri       : желать
diablo       : дьявол, чёрт
diafana      : прозрачный
diafragmo    : диафрагма
diagnozo     : диагноз
diakrita     : диакритический
dialekta     : диалект
dialogo      : диалог
diapazono    : диапазон
dieto        : диета
difekti      : портить, повреждать
diferenci    : отличаться, различаться
difini       : назначать, определять
diftongo     : дифтонг
digesti      : переваривать
digno        : честь, достоинство
digo         : плотина, дамба
dika         : толстый
diktatoro    : диктатор
diligenta    : трудолюбивый; прилежный
dimancxo     : воскресенье
dimensio     : измерение, размер
dinamiko     : динамика
dio          : бог
diplomatio   : дипломатия
diplomato    : дипломат
diplomo      : диплом
dipsomanio   : дипсомания, запой
direkti      : направлять; управлять
direktoro    : директор
diri         : сказать
disciplino   : дисциплина
discxiplo    : последователь, ученик
disertajxo   : диссертация
diserto      : диссертация
disidento    : диссидент, инакомыслящий
disko        : диск, грампластинка
diskreta     : осторожный; скромный
diskuti      : обсуждать, дискутировать
dismeti      : раскладывать, размещать
disponi      : располагать; распоряжаться
dispozicio   : расположение; предписание
disputi      : спорить; ссориться
distanco     : расстояние, дистанция
distingi     : отличать, различать
distri       : развлекать; отвлекать
distribui    : распределять
distrikto    : район
diurno       : сутки
divano       : диван
diveni       : угадать, разгадать
diversa      : разный, разнообразный
diversio     : диверсия
dividi       : делить; разделять
do           : итак, следовательно
dogano       : таможенная пошлина
dogmo        : догма, догмат
doktoro      : доктор; врач
doktrino     : теория, учение, доктрина
dokumento    : документ
dolaro       : доллар
doloro       : боль
domagxi      : жалеть; щадить
domini       : доминировать, господствовать
domo         : дом, здание
donaco       : дар, подарок
doni         : давать, вручать
dorloti      : баловать; изнеживать
dormi        : спать
dorno        : колючка, заноза; шип
dorso        : спина, спинка; обратная сторона
doto         : приданое
dozo         : количество; доза порция
drato        : проволока, провод
dresi        : дрессировать; муштровать
drinki       : пьянствовать
droni        : утопать, тонуть
du           : два
dubi         : сомневаться
duelo        : поединок, дуэль
duko         : герцог
dum          : в течение, во время
dungi        : нанимать
dura         : суровый; твердый
ebena        : плоский, ровный
ebria        : пьяный, опьяненный
ebla         : возможный
ecx          : даже
edifi        : назидать, наставлять, поучать
eduki        : воспитывать; выращивать; развивать
edzo         : муж, супруг
efektiva     : эффективный, действительный; действенный
efekto       : эффект, впечатление
efemera      : мимолётный, эфемерный
efiki        : воздействовать; действовать
egala        : равный
egoismo      : эгоизм
egoisto      : эгоист
ehxi         : отзываться эхом
ehxo         : эхо; отклик
ekipi        : экипировать; оборудовать, оснащать
ekologio     : экология
ekonomio     : экономия; хозяйство
ekrano       : экран; ширма
eksceso      : эксцесс, излишество
eksciti      : волновать; вызывать; подстрекать
eksklamacio  : возглас, восклицание
eksklamo     : возглас, восклицание
ekskluziva   : исключительный
ekskursi     : совершать экскурсию
ekspansio    : распространение, экспансия
ekspedi      : отсылать, направлять
eksperimento : опыт, испытание, эксперимент
eksplodi     : взорваться
ekspluati    : эксплуатировать; использовать
eksponi      : экспонировать; излагать
ekspozicio   : выставка, экспозиция
ekster       : вне, снаружи
ekstermi     : истреблять, искоренять
ekstravaganco : необычность
ekstrema     : экстремальный; чрезмерный
ekvilibro    : равновесие
ekvivalento  : равноценность
ekzakta      : правильный, точный
ekzameni     : экзаменовать; исследовать
ekzekuti     : казнить
ekzemplero   : экземпляр
ekzemplo     : пример
ekzerzi      : упражнять, тренировать
ekzili       : ссылать, изгонять
ekzisti      : существовать
ekzota       : диковинный, экзотический
ekzotika     : диковинный, экзотический
el           : из
elasta       : упругий, гибкий
elefanto     : слон
eleganta     : изящный, элегантный
elegio       : элегия
eleksiro     : эликсир
elekti       : выбирать, избирать
elektro      : электричество
elemento     : элемент; основа, начало; стихия
elipso       : эллипс
elito        : элита
elokventa    : красноречивый
embaraso     : затруднение, помеха; смущение
emblemo      : эмблема
embrazuro    : амбразура
embusko      : засада
emerito      : пенсионер
emfazo       : эмфаза, напряжённость; выделение, подчёркивание
eminenta     : выдающийся, знаменитый
emisii       : излучать; испускать
emocio       : эмоция, волнение; чувство
en           : в
enciklopedio : энциклопедия
energio      : энергия
engagxi      : вовлекать; приглашать
enigmo       : загадка
enketi       : опрашивать
enorma       : громадный, огромный
ensemblo     : ансамбль; комплект; совокупность
entrepreni   : предпринимать, браться
entuziazmo   : энтузиазм
enui         : скучать
envii        : завидовать
epiteto      : эпитет; определение
epizodo      : эпизод
epoko        : эпоха
erao         : эра
erari        : ошибаться
erco         : руда
erudicio     : эрудиция
escepto      : исключение
eseo         : очерк, эссе
eskari       : избавиться, избежать
eskorto      : эскорт, конвой, охрана
esperanto    : эсперанто
esperantologio : эсперантология
esperantologo : эсперантолог
esperi       : надеяться, уповать
esplori      : изучать; расследовать
esprimi      : выражать
estetiko     : эстетика
esti         : быть, находиться
estimi       : уважать; ценить
estingi      : гасить
estrado      : эстрада
etagxo       : этаж
etapo        : этап
etendi       : простирать; расправлять
eterna       : вечный
etero        : эфир
etikedo      : этикетка, ярлык
etiketo      : этикет, церемониал
etno         : этнос, нация
etoso        : атмосфера, дух
euxfemismo   : эвфемизм
evento       : происшествие, событие
eventuala    : вероятный, возможный
evidenta     : очевидный, явный
eviti        : избегать, уклоняться
evolucio     : развитие, эволюция
evoluo       : развитие, эволюция
fabelo       : сказка, выдумка
fablo        : басня
fabriko      : фабрика, завод
faceto       : грань
facila       : лёгкий
fadeno       : нить, нитка
fajfi        : свистеть
fajro        : огонь
fako         : отдел, отделение; отрасль
fakto        : факт
faktoro      : фактор
fakturo      : фактура, накладная
fakultato    : факультет
faldo        : складка; сборка
fali         : падать; уменьшаться; понижаться
falsa        : фальшивый, неверный
fama         : знаменитый, славный
familiara    : фамильярный
familio      : семья
fandi        : плавить, растапливать
fanfaro      : фанфара
fanfaroni    : хвастаться
fantasta     : фантастический
fantazio     : фантазия, воображение
fantomo      : привидение, призрак
farbo        : краска
fari         : делать, совершать; изготовлять
farmo        : ферма; аренда
farti        : чувствовать себя; жить, поживать
fasxismo     : фашизм
fasxisto     : фашист
fatraso      : отбросы; хлам
fauxko       : глотка, зев; пасть
favora       : благосклонный
febla        : слабый
febro        : лихорадка; высокая температура
februaro     : февраль
federacio    : объединение; федерация
fekunda      : плодородный
felicxa      : счастливый
felo         : шкура, необработанный мех
femuro       : бедро, ляжка
fendo        : разрез, разрыв; трещина, щель
fenestro     : окно
fenomeno     : явление; феномен
ferio        : каникулы; отпуск
fermi        : закрывать
fero         : железо
fervora      : усердный, ревностный
festeni      : пировать
festi        : праздновать
festivalo    : фестиваль
feuxda       : феодальный
fiancxo      : жених
fiasko       : неудача, провал, фиаско
fibro        : фибра, волокно, жилка
fidela       : верный, преданный; достоверный
fidi         : доверять, верить, полагаться
fiera        : гордый, высокомерный
figuro       : фигура, изображение, образ
fikcio       : фикция, вымысел; фантазия
fiksi        : закреплять, фиксировать; назначать
filantropio  : филантропия, благотворительность
filatelo     : филателия
filio        : отделение, филиал
filmo        : фильм
filo         : сын
filologio    : филология
filologo     : филолог
filozofio    : философия
filozofo     : философ
financo      : финансы, денежные средства
fingro       : палец
fini         : кончить, завершить
firma        : крепкий, твердый
firmao       : фирма
fisko        : государственная казна
fisxo        : рыба
fiziko       : физика
fiziologio   : физиология
fizionomio   : физиономия
flago        : флаг
flamo        : пламя
flanka       : боковой, второстепенный
flari        : нюхать, обонять
flati        : льстить; ласкать; быть приятным
flava        : жёлтый
flegi        : ухаживать; поддерживать; выхаживать
fleksi       : гнуть, сгибать
flirti       : флиртовать; развеваться
floro        : цветок
flugi        : летать
flui         : течь
flustri      : шептать, шелестеть
foiro        : рынок, ярмарка
fojno        : сено
fojo         : раз
foko         : тюлень
fokuso       : фокус
folio        : лист
folkloro     : фольклор
fondi        : основать, учредить; обосновать
fonemo       : фонема
fonetiko     : фонетика
fono         : фон
fonologio    : фонология
fonto        : источник, родник
for          : вон, прочь
forgesi      : забыть
forgxi       : ковать
forko        : вилка
formacio     : формация; пласт, построение
formala      : формальный
formiko      : муравей
formo        : форма; образование
formulo      : формула
fornelo      : плита кухонная
forno        : печка
forta        : сильный
fortika      : крепкий, прочный
fortreso     : крепость
fortuno      : фортуна, судьба
forumo       : форум
fosi         : копать, рыть
fosilio      : ископаемое, окаменелость
fosto        : столб
fotelo       : кресло
foti         : фотографировать
fotografi    : фотографировать
fotografio   : фотография
fragila      : ломкий, хрупкий
fragmento    : фрагмент, отрывок; обломок
frakasi      : разбивать вдребезги; громить, сокрушать
frako        : фрак
frandi       : лакомиться
frapi        : стучать, ударять; поражать
frato        : брат
frauxlo      : неженатый, холостой; юноша
frazeologio  : фразеология
frazo        : фраза, выражение
frekventi    : часто посещать
fremda       : иностранный; чужой
freneza      : сумасшедший
fresxa       : свежий
frida        : холодный
fripono      : жулик, мошенник, плут
friti        : жарить
frivola      : легкомысленный, фривольный
frizi        : делать прическу, завивать волосы
fromagxo     : сыр
fronti       : обращаться
fronto       : фронт; передняя сторона
frosto       : мороз; озноб
frua         : ранний
frukto       : фрукт, плод; результат
frunto       : лоб
fugxi        : бежать; спасаться
fulmo        : молния
fumi         : дымить; курить
fumo         : дым
fundamento   : основа, фундамент
fundo        : глубина; дно; основание
funebro      : траур
funkcii      : функционировать, работать
funkcio      : функция
furagxo      : фураж
furioza      : бешеный; свирепый, яростный
furoro       : фурор
fusilo       : ружьё
fusxi        : делать кое-как; портить
futuro       : будущее; будущее время
gaja         : весёлый
gajni        : выигрывать; получать, приобретать
galerio      : галерея
galimatio    : бессмыслица, галиматья
galopo       : скачка, галоп
gamo         : гамма; диапазон
gapi         : глазеть, ротозейничать
garantii     : гарантировать, обеспечивать
gardi        : беречь, стеречь, хранить
gaso         : газ
gasto        : гость
gastrito     : гастрит
gazeto       : газета; журнал
generalo     : генерал
generi       : генерировать, плодить; производить
genetiko     : генетика
genio        : гений
gento        : племя; род; народ
genuo        : колено
geofiziko    : геофизика
geografio    : география
geografo     : географ
geologio     : геология
geologo      : геолог
gerilo       : партизанская война
gesti        : жестикулировать
gicxeto      : окошко, форточка
giganto      : великан, исполин
gimnastiko   : гимнастика
gimnazio     : гимназия
gitaro       : гитара
glacio       : лёд
gladi        : гладить, утюжить
glasnosto    : гласность
glaso        : стакан
glata        : гладкий, ровный
glavo        : меч
gliti        : скользить
globo        : шар; глобус
gloro        : слава
gluo         : клей
gluti        : глотать
gorgxo       : горло
gracia       : грациозный, изящный
gradacio     : градация; постепенность
grado        : градус; степень
gramatiko    : грамматика
gramo        : грамм
granda       : большой; великий
grandioza    : грандиозный
granito      : гранит
graso        : жир
gratuli      : поздравлять
grava        : важный, серьёзный
graviti      : тяготеть
grego        : стадо
greno        : зерно
grimaco      : гримаса
grimpi       : взбираться, подниматься
grio         : крупа
griza        : серый
grizharulo   : седой
groteska     : причудливый, забавный
grumbli      : ворчать, брюзжать
grundo       : грунт, почва; земля
grunti       : хрюкать
grupo        : группа
gubernio     : губерния
gudro        : гудрон; дёготь; смола
gulasxo      : гуляш
gusto        : вкус
guto         : капля
gvati        : выслеживать, подстерегать; подглядывать
gvidi        : руководить, править; вести, провожать
gxangalo     : джунгли, заросли
gxardeno     : сад, огород
gxemi        : стонать, охать, вздыхать
gxenerala    : всеобщий, генеральный
gxeni        : беспокоить; стеснять; мешать
gxenro       : жанр
gxentila     : вежливый
gxermo       : зародыш, росток
gxi          : он, она, оно (о вещи или о животном)
gxino        : джин
gxis         : до
gxoji        : радоваться
gxui         : наслаждаться
gxusta       : правильный, точный
ha           : а; ах, ха
hajlo        : град
haki         : колоть, рубить
hallo        : алло
halo         : зал, холл
halti        : останавливаться
hamako       : гамак
handikapo    : помеха; физический недостаток
hardi        : закалять
harmonio     : гармония, согласие
haro         : волос
hasti        : спешить, торопиться; мчаться
hauxto       : кожа (на человеке или животном)
haveno       : гавань, порт
havi         : иметь; владеть, обладать
hazardo      : неожиданность; случай
hejmo        : дом, семейный очаг
hela         : светлый, ясный; яркий
helpi        : помогать
heni         : ржать
hepato       : печень
herbo        : трава
heredi       : наследовать
herezo       : ересь, лжеучение
hermeta      : герметический
hermetika    : герметический
heroldo      : глашатай, герольд
heroo        : герой
heziti       : колебаться, пребывать в нерешительности
hibrido      : помесь, гибрид
hidrogeno    : водород
hieraux      : вчера
himno        : гимн
hiperbolo    : преувеличение, гипербола
hipokriti    : лицемерить
hirundo      : ласточка
historio     : история
hm           : гм
ho           : ох
hobio        : любимое занятие, хобби
hobojo       : гобой
hodiaux      : сегодня
hola         : алло; привет; эй
holmo        : холм
homo         : человек
homogena     : однородный
honesta      : честный
honorario    : гонорар
honoro       : почёт, честь
honti        : стесняться, стыдиться
horizontalo  : горизонталь
horizonto    : горизонт
horlogxo     : часы
horo         : час
hororo       : ужас
hospitalo    : больница
hotelo       : гостиница
hufo         : копыто
huligano     : хулиган
humana       : гуманный, человеколюбивый
humida       : влажный, сырой
humila       : покорный, смиренный, униженный
humoro       : настроение
humuro       : юмор
hundo        : собака
hura         : ура
hxalato      : халат
hxameleono   : хамелеон
hxanlando    : ханство
hxano        : хан
hxaoso       : хаос
hxato        : хата
hxemio       : (kemio)   химия
hxirurgio    : хирургия
hxolero      : холера
hxoralo      : хорал
hxordo       : хорда
hxoro        : хор
ia           : какой-то
iai          : кричать (об осле)
ial          : почему-то
iam          : когда-то
idealo       : идеал
identa       : идентичный, тождественный
ideo         : идея, мысль, представление
ideologio    : идеология
idilio       : идиллия
idiotismo    : идиотизм
idioto       : идиот
ie           : где-то
iel          : как-то
ien          : куда-то
ies          : чей-то
ignori       : игнорировать
ili          : они
ilumini      : освещать, озарять
ilustri      : иллюстрировать
iluzio       : иллюзия; заблуждение
imagi        : воображать
imiti        : имитировать
imperio      : империя
impertinenta : бесстыдный, наглый
impeti       : устремляться, порываться, бросаться вперёд
implici      : содержать в себе, подразумевать
imponi       : импонировать, внушать уважение
imposto      : налог, пошлина
impreso      : впечатление
improvizi    : импровизировать
impulso      : порыв, импульс; толчок
inauxguro    : торжественное открытие
inciti       : дразнить; раздражать сердить
indiferenta  : безразличный, равнодушный
indigni      : возмущаться
indigxeno    : абориген, коренной житель
indiki       : обозначать, указывать
individuo    : личность, индивидуум
industrio    : промышленность, индустрия
infano       : дитя, ребёнок
infarkto     : инфаркт
infero       : ад
inflacio     : инфляция
influi       : влиять
informi      : сообщать, информировать
ingxenia     : искусный, находчивый
ingxeniero   : инженер
inici        : вводить, посвящать (во что-нибудь)
iniciati     : проявлять инициативу; начинать
iniciatoro   : инициатор
injekti      : вспрыскивать, делать инъекцию
inklina      : склонный
inkluzive    : включительно
inkubo       : кошмар
insekto      : насекомое
insidi       : строить козни, ловушку; посягать
insigno      : значок
insisti      : настаивать
inspiri      : вдохновлять; внушать
instali      : установить, оборудовать; устраивать
instancio    : инстанция, орган государственного управления
instigi      : побуждать; подстрекать; натравливать
instinkto    : инстинкт
institucio   : учреждение
instituto    : институт
instrui      : преподавать; учить, наставлять
instrumento  : инструмент, орудие, прибор
insulo       : остров
insulti      : бранить, ругать; оскорблять
integra      : единый, целостный, неотъемлемый
intelekto    : разум, рассудок, интеллект
inteligenta  : образованный, смышлёный; интеллигентный
intenci      : намереваться, замышлять
intensa      : напряжённый, интенсивный
inter        : между, среди
intereso     : интерес
interjekcio  : междометие
interlingvistiko : интерлингвистика
intermiti    : перемещаться, быть прерывистым
intermonto   : ущелье
interna      : внутренний
interpreti   : объяснять; переводить (устно)
intervjuo    : интервью
intesto      : кишка
intima       : близкий, задушевный, интимный
intrigi      : возбуждать любопытство, интриговать
intuicio     : предчувствие, интуиция
inundi       : заливать, наводнять
invadi       : вторгаться, проникать; захватывать
invalido     : инвалид
inventi      : изобретать
inversa      : обратный, противоположный;
inversio     : обратный порядок, инверсия
inviti       : пригласить, позвать
io           : что-то
iom          : сколько-то
iri          : ходить, идти; двигаться
ironio       : ирония, насмешка
iu           : кто-то
izoli        : отделять, изолировать, разобщать
ja           : ведь, же
jako         : куртка, пиджак
jam          : уже
januaro      : январь
jaro         : год
jasmeno      : жасмин
je           : в, на
jelpi        : визжать; скулить
jen          : вон, вот
jes          : да
jogo         : йога
ju           : чем
jubileo      : юбилей, годовщина
judo         : еврей
juglando     : грецкий орех
jugo         : иго, гнёт, ярмо
jugxi        : судить; полагать; обсуждать, решать
juki         : зудеть, чесаться
julio        : июль
juna         : молодой, юный
jungi        : запрягать
junio        : июнь
jupo         : юбка
juro         : право, юриспруденция
justa        : справедливый, правильный
justico      : правосудие, юстиция
juvelo       : драгоценность; сокровище
jxaketo      : жакет, куртка
jxako        : переключатель
jxaluza      : ревнивый
jxami        : глушить
jxargono     : жаргон
jxauxdo      : четверг
jxeti        : бросать, кидать, метать
jxetkubo     : игральная кость
jxinso       : джинсы
jxuri        : клясться, присягать
jxurio       : жюри
jxurnalo     : газета; дневник
jxurrompanto : клятвопреступник
jxus         : только что
kabaredo     : кабаре
kabineto     : кабинет
kacxo        : каша, пюре; путаница, неразбериха
kadavro      : труп
kadenco      : ритм, темп; размер
kadro        : кадр; рама; рамка
kaduka       : ветхий, дряхлый
kafeterio    : кафетерий; закусочная
kafo         : кофе
kaj          : а, и
kajero       : тетрадь
kajo         : набережная; пристань; перрон, платформа
kakto        : кактус
kaldrono     : котёл
kalendaro    : календарь
kalkuli      : вычислять; считать; считаться
kalsono      : кальсоны; панталоны
kalumnii     : клеветать, чернить; позорить
kalva        : лысый
kamarado     : товарищ
kamelo       : верблюд
kamerao      : кинокамера
kamero       : кинокамера
kamiono      : грузовик
kampanjo     : кампания; акция
kampo        : поле
kanajlo      : каналья, негодяй, подлец
kanalo       : канал
kanario      : канарейка
kancelario   : канцелярия
kandidato    : кандидат
kano         : тростник
kanono       : орудие, пушка; канон; правило
kanti        : петь
kantono      : кантон
kaoso        : (haoso)               хаос
kapabla      : способный
kapitalo     : капитал
kapitan      : капитан
kapo         : голова
kapreolo     : косуля
kaprico      : каприз
kapro        : коза; козёл
kapti        : ловить, поймать; схватить
kaputa       : испорченный; разбитый; погибший
kara         : дорогой
karakterizi  : характеризовать
karaktero    : характер
karbo        : уголь
karcero      : карцер; тюрьма
karesi       : гладить, ласкать
kariero      : карьера
karikaturo   : карикатура
karitato     : милосердие, человеколюбие
karno        : плоть, тело
karoto       : морковь
karto        : карта; карточка
karuselo     : карусель
kasedo       : кассета
kaserolo     : кастрюля
kaso         : касса
kastelo      : замок
kasxi        : прятать; скрывать, утаивать
kataklismo   : катаклизм, катастрофа
katakombo    : катакомба
katalogo     : каталог
katastrofo   : катастрофа
katedralo    : собор
katedro      : кафедра
kategorio    : категория, разряд
kateno       : оковы, цепь
kato         : кот; кошка
katodo       : катод
kaucxuko     : каучук; резина
kauxzo       : основание, причина
kavaliro     : кавалер; рыцарь
kaverno      : каверна; пещера
kaviaro      : икра (еда)
kavo         : впадина, углубление; дупло; ров; яма
kazemato     : каземат
kazerno      : казарма
kazino       : казино
kazo         : падеж, случай
ke           : что; чтобы
kelka        : некоторый
kelkaj       : несколько
kelnero      : официант
kemio        : (ĥemio)      химия
kerno        : ядро; зерно, плод
kesto        : ящик
kia          : какой
kial         : почему
kiam         : когда
kibernetiko  : кибернетика
kie          : где
kiel         : как
kien         : куда
kies         : чей
kilogramo    : килограмм
kilometro    : километр
kinematografo : кинематограф, кино
kino         : кинематограф, кино
kio          : что
kiom         : сколько
kiraso       : броня; латы, панцирь
kirli        : взбалтывать, размешивать; вертеть, крушить
kisi         : целовать
kiu          : кто
kivio        : киви
klabo        : дубинка
klacxi       : сплетничать; судачить
klaki        : стучать, хлопать; щелкать
klano        : клан, род
klara        : светлый, ясный
klasifiki    : классификация
klasika      : классический
klaso        : класс
klavo        : клавиша
kleo         : ключ (музыкальный); атмосфера, настрой, характер
klera        : образованный, просвещённый
kliento      : клиент
klimato      : климат
klini        : нагибать, наклонять
kliniko      : клиника
klisxo       : клише
klopodi      : заботиться, стараться; хлопотать, ходатайствовать
klostro      : монастырь
klubo        : клуб
knabo        : мальчик; парень
knari        : скрипеть, хрустеть; трещать
knedi        : месить, мять
kobajo       : морская свинка
kodekso      : кодекс
kodo         : код
kohorto      : когорта
koincidi     : совпадать
koko         : петух
kokso        : бедро, ляжка; таз
kolbaso      : колбаса
kolego       : коллега
kolektivo    : коллектив
kolekto      : коллекция, собрание
koleri       : злиться, сердиться
kolhxozo     : колхоз
kolizii      : сталкиваться, вступать в конфликт
kolo         : шея
kolombo      : голубь
kolonio      : колония
koloro       : цвет; колорит, окраска; тембр
komandi      : командовать, приказывать
kombajno     : комбайн
kombi        : причесывать
kombini      : комбинировать, соединять, сочетать
komedio      : комедия
komenci      : начинать
komentarii   : комментировать
komenti      : комментировать
komerci      : заниматься коммерцией, торговать
komforto     : комфорт, удобство, уют
komisaro     : комиссар
komisii      : поручать
komisiono    : комиссия
komitato     : комитет
komizo       : продавец
komo         : запятая
kompanio     : компания
kompano      : приятель
kompari      : сравнивать
kompaso      : компас
kompati      : жалеть, сочувствовать
kompensi     : компенсировать, возмещать
kompetenta   : компетентный, сведущий
kompili      : компилировать; составлять
komplekso    : комплекс, совокупность
kompleta     : законченный, полный
komplezi     : быть любезным
komplika     : сложный; запутанный
komponi      : сочинять музыку; соединять (химический процесс)
komposti     : верстать; набирать (буквы)
kompreni     : понимать
kompromiso   : компромисс
komputi      : вычислять; считать
komsomolo    : комсомол
komuna       : общий, совместный
komuniki     : сообщать
komuti       : перемещать, переставлять; переводить, переключать
koncentri    : концентрировать
koncepto     : концепция; понятие, представление
koncerni     : касаться, относиться
koncerto     : концерт
konciza      : краткий; лаконичный
kondamni     : приговорить, осудить
kondicxo     : состояние; условие
kondolenci   : соболезновать
konduki      : вести; приводить к чему-нибудь
konduktanco  : проводимость
konduti      : вести себя
konfederacio : конфедерация
konfedero    : конфедерация
konferencio  : конференция; совещание
konfesi      : признавать; исповедоваться
konfesio     : вероисповедание
konfidi      : доверять что-нибудь
konfirmi     : подтверждать, утверждать
konfiski     : конфисковать, изымать
konflikto    : конфликт, столкновение
konforma     : сообразный, соответствующий
konfuzi      : смущать; приводить в замешательство
kongreso     : съезд; конгресс
kongrui      : совпадать, совмещаться
koni         : знать; быть знакомым; быть осведомленным
konjako      : коньяк
konjekti     : догадываться, предполагать
konkeri      : завоёвывать, покорять
konkludi     : делать вывод, заключать
konkreta     : конкретный
konkurenco   : конкуренция
konkuri      : соревноваться, состязаться
konkurso     : состязание, смотр, конкурс
konscii      : сознавать
konsekri     : посвящать в сан
konsenti     : соглашаться
konservativa : консервативный
konservatorio : консерватория
konservi     : беречь, хранить
konsideri    : обдумывать, рассматривать; учитывать
konsili      : советовать, рекомендовать
konsilio     : совет (учреждение)
konsisti     : состоять
konsoli      : утешать
konsonanto   : согласный звук
konspiri     : конспирировать, замышлять заговор
konstanta    : постоянный
konstati     : подтверждать, констатировать
konsterni    : озадачивать, поражать; приводить в ужас
konstipi     : вызывать запор
konstitucio  : конституция
konstitui    : основывать, учреждать
konstrui     : строить
konstukcio   : конструкция
konsulti     : консультироваться
kontakto     : общение, контакт, соприкосновение
kontempli    : рассматривать, созерцать
kontenta     : довольный, удовлетворённый
kontesti     : опровергать, оспаривать
kontinento   : континент
kontingento  : состав, контингент
kontinua     : непрерывный, сплошной
kontrakti    : договариваться; заключить договор, контракт
kontrasto    : контраст, противоположность
kontraux     : против, напротив
kontribui    : содействовать; вносить вклад; способствовать
kontroli     : проверять, контролировать
konturo      : очертание, контур
kontuzi      : контузить; ушибить
konvena      : подходящий, уместный
konvergxi    : сосредотачиваться, сходиться
konversacii  : беседовать, разговаривать
konversi     : беседовать, разговаривать
konvinki     : убеждать, уверять
kooperativo  : кооператив
kopeko       : копейка
kopio        : копия
korbo        : корзина
kordo        : струна
korekti      : исправлять, корректировать
korelativa   : соотносительный, коррелятивный
korespondi   : переписываться; соответствовать
koridoro     : коридор
koro         : сердце
korolario    : вывод, следствие; результат
korpo        : корпус; тело
korto        : двор
korvo        : ворон
kosmo        : космос
kosmonauxto  : космонавт
kosti        : стоить
kostumo      : костюм
kosxmaro     : кошмар
kotizo       : членский взнос, доля
koto         : грязь; сор
kotono       : хлопок
koverto      : конверт
kovri        : закрывать, покрывать
kracxi       : плевать
krajono      : карандаш
krampo       : скобка; скоба
kravato      : галстук
kredenco     : сервант
kredi        : верить
krei         : создавать, творить;  образовывать
kremlo       : кремль
krepusko     : сумерки
kreski       : расти
krestomatio  : хрестоматия
kreteno      : кретин, слабоумный
kreto        : мел
krevi        : лопаться, трескаться
kribri       : просеивать
krii         : кричать
krimo        : преступление
kripla       : искалеченный, увечный
krispa       : курчавый, вьющийся
kristalo     : кристалл, хрусталь
kriterio     : мерило, критерий
kritiki      : критиковать
krizo        : кризис
krocxi       : прикреплять, цеплять; вешать, подвешивать
krokodilo    : крокодил
krom         : кроме
kronika      : хронический
krono        : корона, венец; крона
kruco        : крест
kruda        : необработанный, сырой; суровый, грубый
kruela       : жестокий, свирепый
kruro        : нога (от колена до ступни)
krusto       : кора, корка
kruta        : крутой, отвесный; резкий
kubo         : куб
kudri        : шить
kuiri        : варить; готовить пищу
kuko         : пирожок, пирог
kukolo       : кукушка
kukumo       : огурец
kulero       : ложка
kulpa        : виноватый, виновный
kulto        : обожествление, культ
kulturo      : культура
kun          : с, с помощью
kuniklo      : кролик
kupeo        : купе
kupro        : медь
kuraci       : лечить
kuragxa      : смелый, храбрый
kurbo        : кривая
kuri         : бежать
kurioza      : занятный, курь„зный
kurso        : курс; курсы
kurta        : короткий
kurteno      : занавес, занавеска
kuseno       : подушка
kusxi        : лежать
kutime       : обычно
kutimo       : обычай, привычка
kuvo         : ванна, чан
kuzo         : двоюродный брат
kvadrato     : квадрат
kvaki        : квакать, крякать
kvalifiki    : квалифицировать
kvalito      : качество, свойство
kvankam      : хотя
kvanto       : количество, величина
kvar         : четыре
kvartalo     : район; квартал
kvarteto     : квартет
kvazaux      : будто, как бы
kvereli      : ссориться
kveri        : ворковать
kvieta       : кроткий, спокойный; тихий
kvin         : пять
kvita        : свободный от долга
kvitanco     : расписка, квитанция
kvizo        : викторина
kvociento    : частное
kvorumo      : кворум
kvoto        : квота, доля, часть
la           : (определённый артикль)
laboratorio  : лаборатория
labori       : работать, трудиться
laca         : усталый
lacerto      : ящерица
lado         : жесть
lafo         : лава
lago         : озеро
lakso        : понос
lakto        : молоко
lamenti      : жаловаться; горевать; причитать
lampo        : лампа
lancxi       : вводить; начинать; спускать
lando        : местность; страна
lango        : язык (анатом. понятие)
langvoro     : истома, томление; нега
lano         : шерсть
lanta        : медленный
lanterno     : фонарь
lardo        : сало
largxa       : обширный, широкий
larmo        : слеза
lasi         : оставлять, покидать
lasta        : последний
lato         : планка, рейка, дранка
laux         : по, согласно
lauxdi       : хвалить, восхвалять
lauxreato    : лауреат
lauxro       : лавр
lauxta       : voĉo           громкий голос
lavango      : лавина
lavi         : мыть, умывать; стирать
lazura       : лазурный
leciono      : урок, лекция, занятие
legendo      : легенда
legi         : читать
legitimi     : узаконить, удостоверить
legomo       : овощ
legxera      : доступный; изящный; лёгкий; слабый
legxo        : закон
lekcio       : лекция
leksiko      : лексика, словарь
leono        : лев
leporo       : заяц
lerni        : учиться; изучать
lerta        : искусный, ловкий, умелый
letero       : письмо
levi         : повышать, поднимать
li           : он
libera       : свободный; независимый; незанятый
libido       : половое влечение
libro        : книга
lifto        : лифт
ligi         : завязать; связать
ligno        : древесина
ligo         : лига, союз
likvidi      : ликвидировать, уничтожать
limo         : граница, предел
lingvistiko  : языкознание
lingvo       : язык (средство общения)
linio        : линия, черта; строка
linko        : рысь
lino         : лён
lipo         : губа
liriko       : лирика
liro         : лира
listo        : список, опись, перечень
literaturo   : литература
litero       : буква
lito         : кровать; постель
liveri       : доставлять, поставлять
logi         : приманивать; завлекать
logiko       : логика
logxi        : обитать, проживать
loko         : место; местность
longa        : длинный; долгий, продолжительный
loterio      : лотерея
ludi         : играть
lui          : снимать, нанимать; брать напрокат
lukso        : великолепие, пышность, роскошь
lukti        : бороться
luli         : убаюкивать, укачивать
lumi         : светить
lundo        : понедельник
luno         : луна, месяц
lupo         : волк
lupolo       : хмель
lustro       : люстра
macxi        : жевать, пережёвывать
magazeno     : магазин
magio        : магия, волшебство, колдовство
magneto      : магнит
magnetofono  : магнитофон
magra        : скудный; худой
majesta      : величественный
majo         : май
majstro      : мастер; знаток; учитель
majusklo     : прописная буква
makabra      : мрачный, погребальный
maksimumo    : максимум
makulo       : пятно
maleolo      : лодыжка
malgraux     : несмотря на
malica       : злой, зловредный; коварный
mamo         : женская грудь
mangxi       : есть
maniero      : манера, при„м, способ
manifestacio : шествие, демонстрация
manifesti    : обнаруживать, проявлять
maniko       : рукав
manio        : мания
manipuli     : управлять, манипулировать
manki        : недоставать, отсутствовать
mano         : рука; кисть
manovri      : действовать; маневрировать
mantelo      : плащ
manuskripto  : рукопись
mapo         : карта (географическая)
mardo        : вторник
marko        : метка, марка
marmoro      : мрамор
maro         : море
marsxalo     : маршал
marsxi       : маршировать, шагать; ходить
martelo      : молот, молоток
marto        : март
masagxo      : массаж
masivo       : массив
masko        : маска
maso         : масса
masoni       : класть из камня
mastro       : хозяин, владелец
masxino      : станок; машина, механизм
matematiko   : математика
mateno       : утро
materialo    : материал
matroso      : матрос
matura       : зрелый, спелый; взрослый
mauxzoleo    : мавзолей
meandro      : извилина, изгиб
meblo        : мебель
mecenato     : меценат
medaliono    : медальон
medicino     : медицина
medikamento  : лекарство, медикамент
medio        : окружение, среда; сфера, обстановка
mediti       : обдумывать, размышлять
megafono     : громкоговоритель; рупор, мегафон
mejlo        : миля
melankolio   : грусть, меланхолия
melki        : доить
melodio      : мелодия
melono       : дыня
mem          : сам
membro       : член
memori       : помнить
mencii       : упоминать
mendi        : заказывать
menso        : ум, интеллект; дух
mensogi      : лгать, обманывать
mentono      : подбородок
menuo        : меню
mergi        : окунать, погружать
merito       : достоинство, заслуга
merkato      : рынок сбыта; спрос и предложение
merkredo     : среда
mesagxo      : послание; сообщение
metabolo     : обмен веществ
metaforo     : метафора
metalo       : металл
metalurgio   : металлургия
metamorfozo  : метаморфоза, перевоплощение, превращение
meti         : класть, помещать, ставить
metio        : ремесло, промысел
metodo       : метод, способ
metro        : метр
metroo       : метро
metropolio   : столица, метрополия
mezo         : середина
mezuri       : мерить, измерять
mi           : я
miasmo       : миазм, скверна
mielo        : мёд
mieno        : мина, выражение лица
migri        : мигрировать, странствовать
mikrofono    : микрофон
miksi        : смешивать, перемешивать
miksturo     : микстура
mil          : тысяча
milda        : кроткий, мягкий; умеренный
milico       : милиция
miliono      : миллион
militi       : воевать
minaci       : грозить, угрожать
minca        : тонкий
mineralo     : минерал
miniaturo    : миниатюра
ministerio   : министерство
ministro     : министр
mino         : залежь, рудная жила, пласт; мина
minora       : минорный, грустный
minus        : минус
minusklo     : строчная буква
minuto       : минута
miopa        : близорукий
miraklo      : чудо
miri         : удивляться, изумляться
miriado      : мириады
misio        : миссия
mistero      : тайна, таинственность
mitingo      : митинг
mizerikordo  : милосердие, сострадание
mizero       : бедность, нужда
modelo       : образец, модель; макет
modera       : сдержанный, скромный
moderna      : новый, современный
modesta      : непритязательный, скромный
modifi       : видоизменять, модифицировать
modo         : мода
moki         : высмеивать, издеваться
mola         : мягкий
molesti      : надоедать, приставать; преследовать
momento      : момент, мгновение
monarko      : монарх
monato       : месяц
mondo        : мир, вселенная; общество
mono         : деньги
monologo     : монолог
monopolo     : монополия
monotona     : монотонный, однообразный
monstro      : монстр, чудовище
monto        : гора
montri       : показывать, указывать;  выявлять, обнаруживать
monumento    : монумент, памятник
moralo       : мораль, нравственность
mordi        : кусать; жалить;   разъедать
morfologio   : морфология
morgaux      : завтра
morna        : мрачный, хмурый
moro         : обычай; нравы
morti        : умирать
motelo       : мотель
motivo       : мотив, повод
motoro       : мотор, двигатель
movi         : двигать, передвигать;   шевелить
mueli        : дробить; молоть, толочь
mugxi        : реветь
multe        : много
mungi        : сморкаться
murdi        : убивать
murmuri      : бормотать; журчать; роптать; шуметь
muskolo      : мышца
muso         : мышь
musxo        : муха
muta         : беззвучный; немой, онемевший, умолкший
mutuala      : взаимный, обоюдный
muzeo        : музей
muziko       : музыка
muzulmano    : мусульманин
naciismo     : национализм
nacio        : национальность; нация
nafto        : нефть
nagxi        : плавать
naiva        : наивный, простодушный
najbaro      : сосед
najlo        : гвоздь
najtingalo   : соловей
narkotiko    : наркотик
naski        : порождать; рожать
naturismo    : натурализм
naturisto    : натуралист
naturo       : природа
naux         : девять
nauxzi       : тошнить; вызывать отвращение
navigi       : плыть на судне
nazio        : нацист
nazo         : нос
ne           : не; нет
nebulo       : туман
necesa       : необходимый, нужный
negativa     : отрицательный
neglekti     : пренебрегать
negoco       : коммерция, бизнес
negro        : негр
negxo        : снег
nek          : ни
nekrologo    : некролог
nenia        : никакой
nenial       : нипочему, незачем, ни за что
neniam       : никогда
nenie        : нигде
neniel       : никак
nenien       : никуда
nenies       : ничей
nenio        : ничто
neniom       : нисколько
neniu        : никто
neologismo   : новое слово, неологизм
neono        : неон
nepo         : внук
nepre        : непременно, обязательно
nervo        : нерв
nervoza      : нервный
nesto        : гнездо
neta         : беловой, чистовой; чёткий; чистый (о весе, доходе)
neuxtrala    : нейтральный
nevo         : племянник
ni           : мы
nigra        : чёрный
nivelo       : уровень
nobelo       : дворянин
nobla        : благородный, великодушный
noci         : вредить
nocio        : понятие
nokto        : ночь
nombro       : число, количество
nomo         : имя; фамилия; название
nordo        : север
normala      : нормальный, обычный, типичный
normo        : норма; образец, эталон
noto         : заметка, запись; примечание
nova         : новый
novalo       : пар (поле под паром), целина
novelo       : новелла, рассказ; повесть
novembro     : ноябрь
nu           : ну
nuanco       : оттенок, нюанс
nubo         : облако
nuda         : голый, обнажённый
nukleo       : ядро атома, ядро клетки
nuko         : затылок
nukso        : орех
nulo         : нуль
numero       : номер
nun          : сейчас, теперь
nupto        : бракосочетание, свадьба
nur          : лишь, только
nutri        : кормить, питать
oazo         : оазис
obei         : повиноваться, слушаться
obelisko     : обелиск
objekto      : объект, вещь, предмет
objxeti      : возражать
observi      : наблюдать; следовать; соблюдать
obskura      : мрачный, тёмный; неясный,  смутный; неопрятный
obstaklo     : помеха, препятствие
obstina      : настойчивый, упорный;  упрямый
obstrukco    : обструкция; закупорка, затор, завал, преграда
obtuza       : глухой, приглушенный,   притуплённый
oceano       : океан
odori        : пахнуть
ofendi       : обижать; оскорблять
ofensivo     : наступление
oferi        : жертвовать
oferti       : предлагать
oficiala     : официальный
oficiro      : офицер
ofico        : должность, служба
ofta         : многократный, частый
oho          : ага, ох
ok           : восемь
okazi        : происходить, случаться
okcidento    : запад
oktobro      : октябрь
okulo        : глаз
okupi        : занимать; оккупировать
ol           : чем (при сравнении)
olda         : старый (о человеке)
oleo         : масло
olimpa       : олимпийский
omagxo       : почтение, уважение; признательность
ombrelo      : зонтик
ombro        : тень
ondo         : волна
onklo        : дядя
oni          : (безличный оборот [говорят - oni говорят])
onomatopeo   : звукоподражание
operacii     : оперировать
opinii       : думать, полагать
oponi        : возражать, оппонировать
oportuna     : удобный, подходящий
optimismo    : оптимизм
orakolo      : оракул; предсказание, пророчество
orangxo      : апельсин
oratoro      : оратор
ordeno       : орден
ordinara     : простой, обычный, заурядный
ordo         : порядок
ordoni       : приказывать, предписывать
orelo        : ухо
orfo         : сирота
organismo    : организм
organizi     : организовать
organo       : орган
orgojlo      : надменность, спесь, чванство
orienti      : ориентировать
oriento      : восток
orkestro     : оркестр
ornami       : украшать, наряжать
oro          : золото
ortografio   : орфография
oscedi       : зевать
osto         : кость
ovo          : яйцо
ozono        : озон
pacienca     : терпеливый
paco         : мир, покой
pado         : дорожка, тропинка
pafi         : стрелять
pagi         : платить
pagxo        : страница
pajlo        : солома
paki         : укладывать; упаковывать
pako         : пакет;  упаковка, тюк
pala         : бледный
palaco       : дворец
palatalo     : палатальный, нёбный звук (мягкое произношение)
palato       : нёбо
palavro      : многословие, разглагольствование
paletro      : палитра
palmo        : пальма
palpebro     : веко
palto        : пальто
panelo       : панель, пульт, табло; панно
paniko       : паника
pano         : хлеб
panoramo     : панорама
pantalono    : брюки, шаровары, штаны
pantoflo     : тапочка, чувяк
papero       : бумага
parabolo     : парабола; притча
paradi       : проходить строем; выставлять напоказ, щеголять
paradizo     : рай
paradokso    : парадокс
paralelo     : параллель
paralizi     : парализовать
parametro    : параметр
parazito     : паразит
pardoni      : извинить, простить
parenco      : родственник
parkere      : наизусть
parko        : парк
parlamento   : парламент
paro         : пара, чета
parodio      : пародия
paroksismo   : пароксизм, припадок, приступ
paroli       : говорить
paronimo     : пароним
participo    : причастие
partio       : партия
parto        : доля, часть
pasagxero    : пассажир
paseo        : прошедшее время, прошлое
pasero       : воробей
pasi         : проходить, переходить
pasio        : пыл, страсть
pasiva       : пассивный
pasporto     : паспорт
pastro       : пастор, священник
pasxi        : ходить, шагать
pasxti       : пасти
patento      : патент
pato         : сковорода; пат
patoso       : пафос, воодушевление
patriarko    : патриарх
patrioto     : патриот
patro        : отец
pauxti       : дуться, быть недовольным
pauxzo       : пауза, перерыв
pavo         : павлин
peco         : часть, кусок; отрывок; деталь
pedagogio    : педагогика
pedagogo     : педагог, учитель
pedanto      : педант
pejzagxo     : пейзаж, вид
peki         : грешить
pekli        : солить, засаливать; заготавливать впрок
peli         : гнать, подгонять, двигать; преследовать
pelto        : шуба; выделанный мех
pelvo        : таз
pendi        : висеть
penetri      : проникать
peni         : пытаться, стараться
peniko       : кисть, кисточка
pensi        : думать, полагать
pensio       : пенсия
penti        : каяться
pentri       : рисовать, писать красками
per          : посредством
percepti     : воспринимать, ощущать,
perdi        : лишаться, терять
perei        : погибать
perfekta     : совершенный, безупречный
perfidi      : изменять, предавать
perifrazi    : описать, пересказать
periodo      : период
perlo        : жемчуг
permesi      : позволять, разрешать
perpleksi    : приводить в недоумение, ставить в тупик
persekuti    : преследовать, подвергать гонениям
persiko      : персик
persisti     : настаивать, упорствовать
persono      : персона, личность, человек
perspektivo  : перспектива
persvadi     : убеждать, уговаривать
peruko       : парик
pesi         : взвешивать
pesimismo    : пессимизм
pesto        : чума
peti         : просить
petoli       : баловаться, шалить, резвиться
petrolo      : нефть, нефтепродукты (керосин, бензин)
petroselo    : петрушка
petskribo    : заявление
pezi         : весить, иметь вес
pia          : благочестивый, набожный
piano        : пианино, фортепиано
piceo        : ель
piedo        : нога; ступня; ножка
pigo         : сорока
pigra        : ленивый
pijxamo      : пижама
piki         : жалить; кусать; колоть, протыкать
pilgrimi     : паломничать, странствовать
pilko        : мяч
piloto       : пилот, летчик, лоцман
pincxi       : захватывать, сжимать, щипать
pinto        : кончик, острие, шпиль, вершина, верхушка, пик
pioniro      : пионер
pipro        : перец
pirozo       : изжога
pitoreska    : живописный
pizo         : горох
placo        : площадь
placxi       : нравиться
plado        : блюдо (еда и посуда)
plafono      : потолок
plagxo       : пляж
plando       : подошва
planedo      : планета
planko       : пол, настил
plano        : план
planti       : сажать
planto       : растение
plasto       : пластик, пластмасса
plata        : плоский, ровный
pledi        : защищать
plej         : самый (наиболее)
plekti       : завязывать, заплетать, плести, обвивать
plena        : полный, наполненный, переполненный
plendi       : жаловаться, сетовать
pleto        : поднос
plezuro      : удовольствие
pli          : более, больше
plongxi      : нырять
plori        : плакать
plu          : более, больше; далее, дальше
plugi        : бороздить, пахать
plumbo       : свинец
plumo        : перо
pluraj       : многие
plus         : плюс
pluvo        : дождь
po           : по
pocio        : микстура, питье
podio        : подмостки, помост, эстрада
poemo        : поэма
poeto        : поэт
poezio       : поэзия
pokaj        : немногие
pokalo       : бокал, кубок
polarizi     : поляризовать
polico       : полиция
polietileno  : полиэтилен
poligloto    : полиглот
politiko     : политика
poluro       : блеск, лоск; глянец, полировка
poluso       : полюс
polvo        : пыль
pomo         : яблоко
pompo        : великолепие, пышность;  торжественность
ponardo      : кинжал
ponto        : мост
popolo       : народ
populara     : популярный
por          : для
porcio       : порция, паек
pordo        : дверь
porko        : кабан, свинья
porti        : носить
portreto     : портрет
posedi       : владеть, обладать
post         : за, после, через, позади
posteno      : должность, пост
postuli      : требовать
posxo        : карман
posxto       : почта
potencialo   : потенциал
potenco      : власть, господство, могущество
povi         : мочь
povra        : бедный
pozi         : позировать
pozicio      : позиция; положение
pozitiva     : положительный
pragmata     : прагматический
praktiko     : практика, занятие, опыт
prava        : правильный, правый
precedenco   : прецедент
precipe      : главным образом, преимущественно
precipiti    : осаждать, отлагать
preciza      : определенный, точный, ясный
prediki      : проповедовать
prefikso     : префикс, приставка
pregxi       : молиться
prelego      : доклад, лекция
premi        : давить, жать, подавлять, угнетать, тяготить
premio       : премия, награда, приз
premiso      : залог, предпосылка
preni        : брать; воспринимать; нанимать
prepari      : готовить
prepozicio   : предлог
presi        : печатать
preskaux     : почти
preskribi    : предписывать, прописывать
prestigxo    : престиж, авторитет; репутация
preta        : готовый
preteksto    : повод, предлог
pretendi     : претендовать; предъявлять права
preter       : мимо
preterito    : прошедшее время
preventi     : предупреждать, предотвращать
prezenti     : представлять; знакомить; играть, исполнять
prezidento   : президент
prezidi      : председательствовать
prezidio     : президиум
prezo        : цена
pri          : о, об, про
primitiva    : простой, примитивный
principo     : принцип
printempo    : весна
prioritato   : приоритет
prismo       : призма
privata      : личный, частный
privilegio   : привилегия, преимущество; льгота
prizono      : тюрьма
pro          : из-за, ради
probabla     : вероятный
problemo     : проблема, вопрос, задача
procedo      : приём, способ
procento     : процент
procesio     : процессия
proceso      : юридический процесс
procezo      : процесс, смена событий
produkti     : производить, создавать
produkto     : продукт
profano      : профан, невежда
profesio     : профессия
profesoro    : профессор
profeto      : пророк
profilo      : профиль
profito      : выгода, польза, прибыль
profunda     : глубокий
programo     : программа
progresi     : прогрессировать
projekto     : проект
prokrasti    : переносить, откладывать
proksima     : близкий
proleto      : пролетарий
prologo      : пролог
promeni      : гулять, прогуливаться
promesi      : обещать
pronomo      : местоимение
prononci     : произносить
propagandi   : пропагандировать
propagi      : распространять
proponi      : предлагать
proporcio    : пропорция
propozicio   : предложение (фраза)
propra       : собственный
proskripcio  : изгнание, высылка
prospekto    : проспект (описание)
prosperi     : процветать, преуспевать
proteino     : белок, протеин
protekti     : охранять, предохранять; покровительствовать
protesti     : возражать, протестовать
protokolo    : протокол
proverbo     : пословица, поговорка
provi        : пробовать, испытывать, примерять
provinco     : провинция
provizi      : запасать; снабжать
provizora    : временный
provoso      : тюремный надзиратель
prozo        : проза
prudenta     : благоразумный, предусмотрительный
prunti       : взять взаймы
pruvi        : доказывать
pseuxdonimo  : псевдоним
psiko        : психика
psikologio   : психология
publici      : публиковать, выступать в печати
publiko      : публика, общественность
pucxo        : путч
pufa         : вздутый; пухлый; напыщенный
pugno        : кулак
pugo         : ляжка, круп, зад
pulo         : блоха
pulover      : пуловер
pulso        : пульс
puni         : наказывать
punkto       : точка; место
pupitro      : пюпитр; пульт; кафедра
pupo         : кукла
pura         : чистый
purpuro      : багрянец, пурпур
pusxi        : толкать
putino       : проститутка, шлюха
putri        : гнить, разлагаться, портиться
puzlo        : головоломка
rabato       : скидка, льгота, уступка в цене
rabi         : грабить; отнимать;  расхищать
racio        : разум, здравый смысл
radikalo     : радикальный
radiko       : корень
radio        : радио; луч
radioaktiva  : радиоактивный
radiofonio   : радиовещание, радиофония
rado         : колесо
rafini       : рафинировать, очищать
rajdi        : ездить верхом
rajto        : право
raketo       : ракета
rakonti      : рассказывать
rampi        : ползать; пресмыкаться;  унижаться
rando        : край, кромка
rango        : степень, ранг, чин
rano         : лягушка
rapida       : быстрый, скорый
raporti      : рапортовать, докладывать
rara         : редкий
raso         : раса
rauxka       : хриплый
ravi         : восхищать, очаровывать
razi         : брить
reakcio      : реакция
reala        : реальный, действительный
recenzi      : рецензировать
recepto      : рецепт
reciproka    : взаимный
redakcio     : редакция
redakti      : редактировать
redaktoro    : редактор
reflekso     : рефлекс
reflekti     : отражать
reflektoro   : рефлектор
reformatoro  : реформатор
refrakti     : преломлять
refuti       : отвергать, отклонять,  опровергать
regali       : угощать
regi         : править, управлять; владеть языком
regiono      : область
registri     : регистрировать, записывать
regno        : государство
regresi      : регрессировать
regula       : регулярный; правильный
regulo       : правило
regximo      : государственный строй; режим
regxisoro    : режиссёр
regxo        : король
rehabiliti   : реабилитировать
reklamo      : реклама
rekomendi    : рекомендовать
rekompenci   : вознаграждать
rekordo      : рекорд
rekruto      : рекрут, новобранец, призывник
rekta        : прямой
rektoro      : ректор
relativa     : относительный
reliefo      : рельеф; выпуклость; выразительность
religio      : религия
remburi      : набивать; набивать цену
rendevuo     : встреча, свидание
rendimento   : производительность, продуктивность, эффективность
renegato     : ренегат, отступник,  перерожденец
renesanco    : возрождение
renkonti     : встречать
renomo       : реноме, репутация
renversi     : опрокинуть; переворачивать
repertuaro   : репертуар
reprezalio   : репрессия
reprezenti   : воображать; представлять (быть представителем)
reputacio    : репутация, известность, доброе имя
respekti     : почитать, уважать
respondi     : отвечать; быть ответственным, соответствовать
respubliko   : республика
resti        : оставаться, пребывать
restoracio   : ресторан
resumi       : резюмировать, подводить итог
reto         : сетка, сеть
retoriko     : риторика, красноречие
revelacio    : озарение, откровение
revi         : мечтать
revolucio    : революция
revolver     : револьвер
revuo        : журнал; обозрение
rezervo      : резерв, запас
rezidi       : обитать, проживать
rezigni      : отказываться, отрекаться
rezino       : древесная смола
rezisti      : противостоять,  сопротивляться
rezoluta     : непоколебимый, решительный
rezoluzio    : резолюция
rezoni       : рассуждать
rezulto      : результат
ribeli       : восставать
ricevi       : получать
ricxa        : богатый
ridi         : смеяться
rifuzi       : отказываться, отклонять
rigardi      : смотреть; считать
rigida       : жёсткий, твёрдый; застывший, окоченелый
rikani       : зубоскалить, ухмыляться
rikisxo      : рикша
rikolto      : урожай
rilati       : относиться (иметь отношение)
rimarki      : замечать, примечать
rimedo       : способ, средство
rimo         : рифма
ringo        : кольцо
ripeti       : повторять
ripozi       : отдыхать
riprocxi     : упрекать; делать выговор
riski        : рисковать
ritmo        : ритм
rito         : обряд, ритуал, церемония
rivalo       : конкурент, соперник
riveli       : обнаруживать; проявлять
rivero       : река
robo         : платье
rojo         : ручей
roko         : скала; горная порода
rolo         : роль
romano       : роман
romanso      : романс
romantiko    : романтика
rompi        : ломать; нарушать; прерывать; расторгать
rondo        : круг, кружок; окружение, среда
ronki        : храпеть
rosti        : жарить, поджаривать
rozario      : чётки
rozo         : роза
rublo        : рубль
rubo         : мусор, отбросы; хлам
rugxa        : красный
ruino        : руины; гибель, крушение
ruli         : катать; свертывать
rulo         : сверток; рулон
rusto        : ржавчина
rutino       : рутина, косность, шаблон;  навык, сноровка
ruza         : коварный, лукавый, хитрый
sabato       : суббота
sablo        : песок
sagaca       : проницательный
sagao        : сказание
sago         : стрела
sagxa        : умный, мудрый, благоразумный
sako         : мешок; сумка
sakri        : ругаться, проклинать
salajro      : заработная плата
salato       : салат
salmo        : лосось, семга
salo         : соль
salono       : салон; гостиная; зал
salti        : прыгать
saluti       : приветствовать
sama         : одинаковый
sana         : здоровый
sanatorio    : санаторий
sandvicxo    : сандвич, бутерброд
sango        : кровь
sankta       : святой, священный
sarkasmo     : сарказм, ехидство
sata         : сытый
satana       : сатана, дьявол
satelito     : спутник
satiro       : сатира
saturi       : насыщать
sauxco       : соус
savi         : избавить; спасать
sceno        : сцена
scienco      : наука
scii         : знать
scintili     : мерцать
se           : если
seanco       : сеанс; заседание
secesio      : разделение; раскол
sed          : а, но
segi         : пилить
segxo        : стул
seka         : высохший, сушеный
sekretario   : секретарь
sekreto      : секрет, тайна
sekso        : секс, пол
sekundo      : секунда
sekura       : безопасный
sekvi        : следить; следовать; соблюдать
semajno      : неделя
seminario    : семинар
semo         : семя
sen          : без
senco        : значение, смысл
sendi        : посылать
sensacio     : сенсация
senso        : ощущение; чувство
senti        : чувствовать
sentimentala : сентиментальный
sep          : семь
septembro    : сентябрь
septo        : перегородка, стенка
sercxi       : искать
serena       : светлый, ясный; спокойный
sergxento    : сержант
serio        : серия, ряд
serioza      : серьёзный
serpento     : змея
serpo        : серп
seruro       : замок
servi        : служить
servuto      : барщина
ses          : шесть
sesio        : сессия
severa       : строгий, суровый
sezono       : сезон, время года
sfero        : сфера, шар; среда
si           : себя
sidi         : сидеть
siegxi       : осаждать
signalo      : сигнал; гудок; звонок
signifi      : иметь знание
signo        : знак, признак
silabo       : слог
silenti      : молчать
silko        : щёлк
silueto      : силуэт
simbolo      : символ
simila       : подобный, похожий
simio        : обезьяна
simpatio     : симпатия; сочувствие
simpla       : простой, несложный
sindikato    : профсоюз
singularo    : единственное число
singulti     : икать
sinjoro      : господин
sinki        : опускаться, снижаться, погружаться
sinkrona     : синхронный, одновременный
sino         : лоно; чрево, утроба; пучина; недра
sinonimo     : синоним
sintakso     : синтаксис
sireno       : сирена, гудок
sismo        : землетрясение
sistemo      : система
sitelo       : ведро
situacio     : ситуация; местоположения
situo        : положение; расположение
skabelo      : скамеечка
skalo        : шкала; масштаб, размер
skatolo      : коробка; шкатулка
skeleto      : скелет
skeptika     : скептический
skio         : лыжа
skismo       : раскол
skizi        : делать эскиз, набросок;
sklavo       : раб
sklerozo     : склероз
skoldi       : бранить, распекать
skolo        : школа (в науке, литературе и т.п.)
skribi       : писать
skrupulo     : скрупулёзность; совестливость
skui         : трясти; встряхивать;   потрясать
skulpti      : ваять, лепить
skurgxo      : плеть, нагайка
slajdo       : слайд, диапозитив
slango       : сленг, жаргон
sledo        : сани
slipo        : карточка
slogano      : лозунг
smajli       : улыбаться
smeraldo     : изумруд
sobra        : трезвый
sociala      : социальный
societo      : общество (объединение)
socio        : общественность
sociologio   : социология
sofisto      : софист
softa        : тихий, мягкий (о звуке)
soifi        : жаждать
sojlo        : порог
sola         : единственный; одинокий
soldato      : солдат; воин
solena       : торжественный, церемониальный
solida       : крепкий; солидный
solidara     : солидарный; сплочённый
solvi        : решать, разрешать
somero       : лето
somnambulo   : сомнамбула, лунатик
soneto       : сонет
songxo       : сон, сновидения; греза
soni         : звучать
sonori       : звенеть
sopiri       : скучать; тосковать;  страстно желать
sorbi        : впитывать, поглощать
sorcxi       : колдовать
sovagxa      : дикий, нелюдимый;  свирепый, хищный
soveto       : совет
spaco        : расстояние; пространство
speciala     : специальный, особый
specifa      : специфический
speco        : вид, сорт; порода
spegulo      : зеркало
spektaklo    : спектакль; зрелище
spekti       : смотреть (спектакль, фильм)
spektro      : спектр
sperta       : искусный; опытный
speso        : условная денежная единица (эсперанто)
spezo        : денежный оборот
spico        : специя, приправа; пряность
spino        : позвоночник, хребет
spiono       : разведчик, шпион
spiri        : дышать
spirito      : дух; душа
spiti        : действовать наперекор
spontana     : непроизвольный
sporto       : спорт
sprita       : остроумный
sprono       : шпора
spuro        : отпечаток, след
sputi        : выплёвывать, харкать
stabila      : стабильный, устойчивый
stablo       : верстак; мольберт; станок
stacio       : станция; остановка;  стоянка
stadio       : стадия
stadiono     : стадион
stafeto      : эстафета; гонец; курьер
stagni       : быть неподвижным, застойным, косным
stampo       : штамп; клеймо
standardo    : знамя
stando       : стенд; стойка
stango       : древко; рычаг; стержень, шест
staniolo     : станиоль, фольга
stari        : стоять; находиться
statistiko   : статистика
statisto     : статист
stato        : положение, состояние
statuo       : статуя
staturo      : осанка; фигура
stelo        : звезда
stepo        : степь
sterko       : навоз, помет; удобрение
sterni       : расстилать, стелить;  распластывать
stertoro     : хрип, хрипение
stilistiko   : стилистика
stilo        : стиль
stimuli      : стимулировать
stinka       : зловонный
stoki        : хранить на складе
stoko        : запас
stomako      : желудок
strabi       : косить (глазами)
strado       : автострада
stranga      : необыкновенный; странный
strategio    : стратегия
strato       : улица
strebi       : стараться; стремиться
strecxi      : напрягать, натягивать
streko       : линия, черта, штрих
streta       : узкий
striki       : бастовать
strikta      : точный, строгий
strio        : лента; полоса
strofo       : строфа
strukturo    : структура, строение
studento     : студент
studi        : заниматься, учиться; изучать; исследовать
stulta       : глупый, тупой
stumbi       : оступаться, спотыкаться
stumpo       : обломок, обрубок; огрызок; отрезок
sturmi       : штурмовать, нападать; впадать в ярость
sub          : под
subite       : внезапно, неожиданно
subjektiva   : субъективный
subjekto     : субъект; подлежащее
sublima      : возвышенный, приподнятый; величественный
substanco    : вещество
substantivo  : имя существительное
substitui    : заменять, замещать
subtila      : мелкий; нежный; тонкий, утонченный
subvencio    : дотация, пособие, субсидия
sucxi        : сосать (кормиться грудью); всасывать
sudo         : юг
suferi       : испытывать боль; мучиться; терпеть
suficxa      : достаточный
sufikso      : суффикс
sufoki       : душить; заглушать,  подавлять
sugesti      : вызывать; внушать; подсказывать, предлагать
suito        : сюита
sukceno      : янтарь
sukcesi      : успевать, иметь успех
sukero       : сахар
suko         : сок
sulko        : борозда; морщина
sumo         : сумма, итог
suno         : солнце
super        : над, сверху
superba      : великолепный
superflua    : лишний, излишний
suplemento   : дополнение; приложение
supo         : суп
supozi       : допускать, предполагать
supro        : верх, вершина
sur          : на
surda        : глухой
surfaco      : поверхность
surogato     : суррогат
surprizi     : удивлять, поражать; застать врасплох
suspekti     : подозревать
suspiri      : вздыхать; стонать
susuri       : шелестеть, шуршать
suvereno     : суверенный правитель
svarmi       : кишеть; быть в изобилии
svastiko     : свастика
svelta       : стройный
sveni        : падать в обморок; терять сознание
svetero      : свитер
svingi       : вилять; качать; махать
sxablono     : шаблон, трафарет, штамп; модель, выкройка
sxafo        : овца
sxajni       : казаться, представляться
sxakalo      : шакал
sxako        : шахматы
sxakto       : шахта, рудник
sxalti       : включать
sxanceli     : колебать, раскачивать
sxanco       : случай, удача, возможность
sxangxi      : менять, изменять
sxargxo      : бремя, груз, нагрузка
sxarko       : акула
sxasxliko    : шашлык
sxati        : нравиться, любить, ценить
sxauxmo      : пена
sxelo        : кожура, кора, скорлупа
sxerci       : шутить
sxi          : она
sxipo        : корабль, судно
sxiri        : срывать, разрывать
sxirmi       : заслонять, укрывать; защищать, охранять
sxlimo       : ил, тина, грязь (лечебная)
sxlosi       : запирать
sxmaci       : хлюпать; чмокать; чавкать
sxminko      : грим; помада; румяна
sxmiri       : мазать, обмазывать
sxoforo      : водитель, шофёр
sxoki        : шокировать, коробить
sxoseo       : шоссе
sxoveli      : сгребать
sxovi        : пихать, совать, толкать
sxovinismo   : шовинизм
sxovinisto   : шовинист
sxpari       : копить, сберегать; экономить
sxpini       : прясть, сучить
sxpuci       : брызгать, прыскать
sxranko      : шкаф
sxrumpi      : сморщиться, покоробиться
sxtalo       : сталь
sxtato       : государство
sxteli       : красть, похищать
sxtipo       : полено; чурбан; обрубок
sxtono       : камень
sxtopi       : закупоривать, затыкать; закрывать
sxtormo      : шторм, буря
sxtrumpo     : чулок
sxtupo       : ступень, ступенька
sxulacxo     : шнурок
sxuldi       : быть в долгу
sxultro      : плечо
sxuo         : башмак, ботинок, туфля
sxuti        : сыпать
sxvabri      : мыть шваброй
sxvabro      : швабра
sxvebi       : парить, реять; висеть в воздухе
sxveli       : опухать; вздуваться, раздуваться
sxvito       : пот, испарина
tabako       : табак
tabelo       : табель
tablo        : стол
tabulo       : доска
tabuo        : запрет, табу
tacxmento    : бригада, команда, отряд
tago         : день
tajdo        : прилив и отлив
tajloro      : портной
tajpi        : печатать на машинке
taksi        : назначать цену; давать оценку
taksio       : такси
takto        : такт; ритм, темп; чувство меры
talento      : талант, дарование
talio        : талия
tamburo      : барабан
tamen        : однако
tanajlo      : клещи, щипцы
tanko        : танк
tarifo       : тариф
tasko        : задание, задача
taso         : чашка
tatui        : татуировать
tauxgi       : годиться
tavolo       : пласт, слой; залежь
teamo        : группа, команда
teatro       : театр
tedi         : надоедать, досаждать, утомлять
tegi         : обтягивать, покрывать; обволакивать
tegmento     : крыша
tegolo       : черепица
tekniko      : техника
teko         : папка, портфель
teksto       : текст
tektoniko    : тектоника
telefono     : телефон
telegramo    : телеграмма
telero       : тарелка
televido     : телевидение
temo         : тема
temperamento : темперамент
temperaturo  : температура
tempio       : висок
templo       : собор, храм
tempo        : время
tendenco     : тенденция; стремление
tendo        : палатка, тент; шатёр
tenera       : нежный
teni         : держать
teniso       : теннис
tenti        : искушать, соблазнять
teo          : чай
teorio       : теория
terapio      : терапия
teritorio    : территория, область
termino      : термин
terminologio : терминология
tero         : земля
teroro       : террор
teruro       : ужас
testamento   : завещание
testi        : тестировать
testudo      : черепаха
tezo         : тезис, положение
tia          : такой
tial         : почему
tiam         : когда
tie          : где
tiel         : как
tien         : куда
ties         : чей
tigo         : ручка инструмента; стебель
tikli        : щекотать
timi         : бояться
tinti        : звенеть, бряцать
tio          : то
tiom         : сколько
tipo         : тип, образец
tiranio      : тирания
tirano       : тиран
tiri         : тащить, тянуть; извлекать
titano       : гигант, исполин; титан
titolo       : титул; заглавие
tiu          : тот
toleri       : терпеть, переносить
tolo         : полотно, холст
tomato       : помидор, томат
tombo        : могила
tondi        : стричь ножницами
tondro       : гром
tono         : тон; звук; лад
tordi        : вить, крутить; искажать
torento      : поток, ливень
torso        : торс
torturi      : пытать, истязать
tosto        : тост
totala       : полный, тотальный
tra          : сквозь, через
trabo        : бревно, брус, балка
tradicio     : традиция
traduki      : перевести
trafi        : метко попадать; заставать; случайно встретить
trafiko      : транспорт; движение
tragedio     : трагедия
tragika      : трагический
trajno       : поезд
trajto       : черта (лица, характера)
trakti       : трактовать, вести переговоры
traktoro     : трактор
tramo        : трамвай
trancxi      : резать
trankvila    : спокойный, тихий
trans        : за, через; по ту сторону
tre          : очень
trejni       : тренировать, обучать; подготавливать
tremi        : дрожать, трепетать
tremolo      : осина
trempi       : макать, окунать, погружать
treni        : волочить, тащить
treti        : топтать; мять; давить
trezoro      : драгоценности; клад; сокровищница
tri          : три
tribunalo    : суд
trinki       : пить
trista       : грустный, печальный
triumfo      : триумф, торжество, победа
triviala     : тривиальный, вульгарный
tro          : слишком
trolebuso    : троллейбус
trompi       : обманывать, вводить в заблуждение
tropiko      : тропик
tropo        : троп (слово в переносном смысле)
trotuaro     : тротуар
trovi        : находить
trudi        : навязывать
trumpeto     : труба (муз. инструмент)
trunko       : туловище; ствол; магистраль
truo         : дыра, отверстие; скважина
trupo        : труппа, войско, отряд
truto        : форель
tuj          : немедленно, сейчас
tuko         : платок, полотнище
tumulto      : суета, суматоха
tunelo       : туннель
turismo      : туризм
turisto      : турист
turmenti     : мучить, терзать
turni        : вертеть, крутить
turo         : башня, вышка
tusxi        : трогать
tuta         : весь, целый
tute         : совершенно, совсем
tutkore      : от всего сердца
ukazo        : указ
ulcero       : язва
ultimato     : ультиматум
ultra        : ультра
umbiliko     : пуп, пупок
ungo         : ноготь, коготь
uniformo     : униформа; мундир
unika        : единственный
unio         : союз (объединение)
unisono      : унисон, согласие
universala   : всеобщий, всемирный; универсальный
universo     : вселенная
univetsitato : университет
unu          : один
unukornulo   : единорог
uragano      : ураган
urbo         : город
uretro       : мочеиспускательный канал
urgxi        : быть срочным, неотложным
urino        : моча
urno         : урна
uro          : зубр
urso         : медведь
urtiko       : крапива
utero        : матка
utila        : полезный
utopio       : утопия
uvo          : виноград
uzi          : использовать
uzino        : завод
uzuristo     : ростовщик
uzuro        : ростовщичество
uzurpi       : узурпировать
vagi         : бродить, блуждать; странствовать
vagono       : вагон
vaki         : быть вакантным, свободным
vakso        : воск; мастика
vakuo        : пустота, вакуум
valida       : действительный; законный
valizo       : чемодан
valo         : долина, ложбина
valoro       : значение, ценность
valvo        : клапан, вентиль; створка; радиолампа
vana         : напрасный, тщетный
vango        : щека
vaporo       : пар
varbi        : вербовать, привлекать; нанимать
varianto     : вариант
varieteo     : эстрадное представление
varii        : изменяться, варьировать; разниться
varma        : тёплый
varo         : продукт, изделие, товар
vaskulo      : сосуд (анатомич. понятие)
vasta        : обширный, просторный
vazo         : ваза, чаша, сосуд, горшок
ve           : увы
vegetalo     : растение
veki         : будить, пробуждать
velki        : блекнуть, вянуть
velo         : парус
vendi        : продавать
vendredo     : пятница
veneno       : отрава, яд
veni         : приходить, приезжать, прибывать
venki        : побеждать, выиграть
vento        : ветер
ventro       : брюхо, живот, утроба
vera         : истинный, подлинный
verbo        : глагол
verda        : зелёный
verdikto     : приговор, вердикт
verdire      : по правде говоря
verko        : произведение; сочинение
vermo        : червь
versio       : версия, толкование
verso        : стих
versxi       : лить
versxajne    : вероятно
vespero      : вечер
vespo        : оса
vestiblo     : передняя, вестибюль
vertikala    : вертикальный
vesto        : одежда
veterano     : ветеран
vetero       : погода
veturi       : ехать
veziko       : пузырь
vi           : ты, вы
viando       : мясо
vibri        : вибрировать, трепетать
vico         : очередь, ряд, строй
vidi         : видеть
vidvino      : вдова
vidvo        : вдовец
vigla        : бодрый, энергичный
viktimo      : жертва
vilagxo      : деревня
vinagro      : уксус
vino         : вино
vintro       : зима
violino      : скрипка
violoncxelo  : виолончель
vipo         : бич, кнут, хлыст
viro         : мужчина
visxi        : вытирать
vitralo      : витраж
vitrino      : витрина
vitro        : стекло
vivi         : жить
vizagxo      : лицо
viziti       : навещать, посещать
vizo         : виза
vocxo        : голос
vojagxi      : путешествовать
vojo         : дорога, путь
vokalo       : гласный
voki         : звать, призывать
volbo        : дуга, свод, выгиб
voli         : хотеть, желать
volonte      : охотно, добровольно
volumo       : том
volvi        : завёртывать, обматывать
vomi         : тошнить
vorto        : слово
vosto        : хвост
vualo        : вуаль; покрывало
vulgara      : пошлый, вульгарный
vulkanizi    : вулканизировать
vulkano      : вулкан
vulpo        : лиса
vundo        : рана; душевная боль
zebro        : зебра
zefiro       : зефир, ветерок
zeloto       : фанатик
zenito       : зенит
zibelo       : соболь
zigzago      : зигзаг
zimo         : брожение
zinko        : цинк
zipo         : застёжка-молния
zizelo       : суслик
zodiako      : зодиак
zono         : регион, пояс; ремень
zoo          : зоосад, зоопарк
zoologio     : зоология
zorgi        : беспокоиться; заботиться, ухаживать
zumi         : жужжать, гудеть; шуметь

